Map1
Easy
16
16
++++++++++++++++
++++++++++++++++
(1)--(2)++++++++++++
+++-++++++++++++
+++-+++(5)---(6)++++
+++-+++-+++-++++
+++-+++-+++-++++
+++-+++-+++-++++
+++-+++-+++-++++
+++-+++-+++-++++
+++(3)---(4)+++-++++
+++++++++++-++++
+++++++++++-++++
+++++++++++(7)---(8)
++++++++++++++++
++++++++++++++++