Map2
Medium
16
16
++++++++++++++++
++++++++++++++++
(1)--(2)++++++++++++
+++-++++++++++++
+++-++++++++++++
+++-+++(7)-------(8)
+++-+++-++++++++
+++-+++-++++++++
+++-+++-++++++++
+++-+++(6)----(5)+++
+++-++++++++-+++
+++-++++++++-+++
+++-++++++++-+++
+++(3)--------(4)+++
++++++++++++++++
++++++++++++++++