Map3
Medium
16
16
+++++++(8)++++++++
+++++++-++++++++
(1)--(2)+++-++++++++
+++-+++-++++++++
+++-+++-++++++++
+++-+++(7)++++++++
+++-+++-++++++++
+++-+++-++++++++
+++-+++(6)----(5)+++
+++-++++++++-+++
+++-++++++++-+++
+++-++++++++-+++
+++(3)--------(4)+++
++++++++++++++++
++++++++++++++++
++++++++++++++++
