Map5
Hard
16
16
+(1)++++++++++++++
+-++++++++++++++
+-++++++++++++++
+(2)-----(3)++++++++
+++++++-++++++++
+++++++-++++++++
+++++++-++++++++
+++++++-++++++++
+++++++-++++++++
+++++++-++++++++
+++++++-++++++++
+++++++-++++++++
+++++++-++++++++
+++++++(4)-------(5)
++++++++++++++++
++++++++++++++++